##################################################
#.........##...##................................#
#.........##...##................................#
#...########...##############........##########..#
#...########...##############........##########..#
#............O.......................##..........#
#....................................##..........#
#...#####....#####......##########...##..........#
#...#####......#####....##########...##..........#
#......#####....####....##...........##..........#
#......#####......##....##...........##..........#
#......#####......##....##...........##..........#
#........######...##....##########################
#........######...##....##########################
######...######...##.................##..........#
######...######...##.................##..........#
######...######...##.................##..........#
######............##.............................#
######............##.............................#
##################################################
