##################################################
#.........##...##................................#
#........%##...##.%..............................#
#...########...##############........##########.%#
#...########...##############........##########..#
#............O...............%.......##..........#
#........%...........................##..........#
#...#####....#####......##########...##..........#
#.%.#####......#####....##########...##..........#
#......#####....####....##...........##..........#
#......#####......##....##E..........##..........#
#......#####......##....##...........##......%...#
#........######...##....##########################
#..%.....######...##....##########################
######...######...##.................##..........#
######...######...##.................##..........#
######...######...##..........%......##....%.....#
######............##.............................#
######.....%......##.............................#
##################################################
