###################################################
#################................................##
##...........####.##############################.##
##.##############........................|..K.##.##
##.#############################.###############.##
##..KKK...|....................|.##########......##
#########.#.##################.#####.....##.#######
#########.#.##################.#####.###.##.#######
##........#.........##########.......###.##.#######
##.################.####################.##.#######
##.################.###.K..|..............|.....###
##.|........|..K..|.###########################.###
##.##.#####.#######.###########################.###
##.##.#####.#######.............................###
##.##....##.##################.####################
##.#####.##.##################.............########
##.#####.##..........#####################.########
##.......###########............................###
###################################################
###################################################
