........................###........................
........................###........................
...#####.#######.#####..###...#####.#######.#####..
........................###...#.................#..
...#.................#..###........................
........................###...#.................#..
...#.................#..###........................
...#####.#######.#####..###...#####.#######.#####..
........................###........................
###################################################
###################################################
........................###........................
...#####.#######.#####..###...#####.#######.#####..
........................###...#.................#..
...#.................#..###........................
........................###...#.................#..
...#.................#..###........................
...#####.#######.#####..###...#####.#######.#####..
........................###........................
........................###........................
